EA  ./ea.xpm
NO  ./north.xpm
SO  ./so.xpm
WE  ./we.xpm

C 055,000,160
F 1,1,1

        1111111 11111111111111111
        1N01001110010000000000001
111111111011000000001111110000001
111101111100100000000000000010001     11111111
111101111100000000000000000000001     10000001
110000000000000100001111111110011     11111111
1000000000000000110000000000000011111111111111
10000000000000001101010010001111111111111111011
11000001110101011111111111111111100000000000001
11110111 1110101 101111010000000000000000000111
11111111 1111111 111111111111111111111111111111111 1
11111111111111111111111111111111111111111111        1111111 11111111111111111
        1001001110010000000000001
111111111011000000001111110000001
111101111100100000000000000010001     11111111
111101111100000000000000000000001     10000001
110000000000000100001111111110011     11111111
1000000000000000110000000000000011111111111111
10000000000000001101010010001111111111111111011
11000001110101011111111111111111100000000000001
11110111 1110101 101111010000000000000000000111
11111111 1111111 111111111111111111111111111111111 1
11111111111111111111111111111111111111111111
